...............+++++
..........++++++++++
...!......a+++++++++
.............+++++++
..............++++++
....+c...........b++
...++++..........+++
....++............++
....................
....................